*********************
*. . .1. . . . .2. .*
*.**.**.*****.**.**.*
*.**.**.*****.**.**.*
*. . . . . . . . . .*
*.**.**.*****.**.**.*
*.**4**.*.P.*.**.**.*
*. . . . . . . . 3 .*
*********************
